00WWWW0
WWW00W0
W00X0WW
W00000W
W0WX00W
W00000W
WWWWWWW
2,1
2,4
3,4
